###############
#             #
#      X      #
#             #
#-------------#
#             #
#      O      #
#             #
###############