#############################################
#                  .........                #
#                  .......                  #
#  P               .  ......                #
#                                           #
#                                           #
#         @                                 #
#                                           #
#                                           #
#                                           #
#############################################